........................................
........................................
.............M..........................
..............,.........................
........MMM.............................
.............MM.........................
..................M.,...................
...............P........................
MMMMMMMMMMMMMMMMMMMMMMMMMMMMMMMMMMMMMMMM
